0 0 0 0 0 0 0 0 0 0 0 0
0 2 2 2 2 2 2 2 2 2 2 0
0 2 2 2 2 2 2 2 2 5 2 0
0 2 2 2 3 0 0 2 2 2 2 0
0 2 2 2 3 0 0 2 2 2 2 0
0 2 2 3 2 2 2 2 2 2 2 0
0 2 3 2 2 4 4 4 4 4 4 0
0 0 0 0 0 0 0 0 0 0 0 0